[文件]
选择到第一个文件=Shift + Home 
选择到最后一个文件=Shift + End 
向前选择=Shift + Left 
向后选择=Shift + Right 
向上一行选择=Shift + Up 
向下一行选择=Shift + Down 
打开文件=Ctrl + Down 
返回上一级=Ctrl + Up 
彻底删除=Shift + Delete 
删除文件=Delete
全选文件=Ctrl + a 
拷贝文件=Ctrl + c 
剪切文件=Ctrl + x 
粘贴文件=Ctrl + v 
重命名=F2 

[新建/搜索]
新建窗口=Ctrl + n 
新建文件夹=Ctrl + Shift + n 
搜索=Ctrl + f

[查看]
文件信息=Ctrl + i 
帮助手册=F1
所有快捷键=Ctrl + Shift + /   
[切换显示状态] 
隐藏文件=Ctrl + h
地址栏输入=Ctrl + l 

[其它]
关闭=Alt + F4      
后退=Alt + left 
前进=Alt + right 
